11111111111111111111111111111111111111111111
100000000000000C00000C0000000000000000000001
10100101001000001010010000000000100000000001
10100100100000100010010000000000C00000000001
100000000100C0000000000000000000000000000001
100000000000000000000000000000000000E0000001
100000000C00C0000000001000000000000000000001
10000000010000000000000000000000000001000001
100000000C00C0000000000000000000100000000001
1P0000000C00C0000000001000000000000000000001
11111111111111111111111111111111111111111111