1111111111111111111111111111111111
100000000000000C00000C000000000001
1E00101010010000010100100000001011
1000010010101010001001000000010101
1P1000000C00C0000000000000000000C1
1111111111111111111111111111111111