1111111111111111111111111111111111
100000000000000C00000C000000000001
1010010100100000101001000000000111
10100100101010100010010000000001C1
1P0000000C00C0000000000000000000E1
1111111111111111111111111111111111